##################
E................#
##..#.#.########.#
#...#...##...#...#
#...#...##..#.#..#
#...#...##.......#
#######.########.#
#######.##...#...#
#.......#..#.....#
#######.########.#
#........#..#....#
#..#..#.##..#....#
#.....#.##.......#
################S#